15,15
[floor1]
0,0,0,0,0,0,0,0,0,0,0,0,0,0,0
0,0,0,A1,0,0,0,0,0,0,0,0,0,0,0
0,0,0,0,0,0,0,0,0,0,0,0,0,0,0
D1,D1,D1,D1,D1,D1,D1,D1,D1,D1,D1,D1,D1,D1,D1
D1,D1,D1,D1,D1,D1,K1,K1,D1,D1,D1,D1,D1,D1,D1
D1,D1,D1,D1,D1,K1,K1,K1,K1,D1,D1,D1,D1,D1,D1
D1,D1,D1,K1,K1,K1,K1,K1,K1,K1,K1,D1,D1,D1,D1
D1,D1,D1,K1,K1,K1,K1,K1,K1,K1,K1,D1,D1,D1,D1
D1,D1,D1,D1,K1,K1,K1,K1,K1,K1,D1,D1,D1,D1,D1
D1,D1,D1,K1,K1,K1,K1,K1,K1,K1,K1,D1,D1,D1,D1
D1,D1,D1,K1,K1,K1,K1,K1,K1,K1,K1,D1,D1,D1,D1
D1,D1,D1,K1,K1,K1,D1,D1,K1,K1,K1,D1,D1,D1,D1
D1,D1,D1,D1,D1,D1,D1,D1,D1,D1,D1,D1,D1,D1,D1
0,0,0,0,0,0,0,0,0,0,0,0,0,0,T1
0,0,0,0,0,0,0,0,0,0,0,0,0,0,0